11111111111111111111
11000111011111100011
11010111010010001011
11000001010110100011
11110101010100101111
11000100000010101111
11011111011010101111
12011111001000100001
11011111101111101111
11010000100001101111
11010111110101101111
11010101010100001111
11000101010111101111
11110000000111100011
11111111111111111111
